11111111111111111111111111111
100000000C00000000C0000000001
1000000P000000000000000000001
1000000C000000C0000C0000C0001
1000C000000C0000C000000C00001
100000E000000000000000000000-1
11111111111111111111111111101