111111111111111111111
100000C0000000C000001
100E00001000000000001
1000000C0000000100001
100PC000001000C000001
100000000000000000001
111111111111111111111