111111111111111111111
100000000000000000001
100E00010000000000001
100X00C000000C0100001
100P00000010000000001
100000000000000000001
111111111111111111111