111111111111111111111
1000C000000000C000001
10XEX00010000C000X001
1000CX0000000C0100001
100P00000C1000000C001
1X000000000X000000001
111111111111111111111