111111111111111111111
100000C0000000C000001
10XEX000100000000X001
10000X0C0000000100001
100PC000001000C000001
1X000000000X000000001
111111111111111111111