111111111111111111111
100000000000000000001
100E00010000000000001
100000C000000C0100001
100P000X0010000000001
100000000000C00000001
111111111111111111111