111111111111111111111
10000000000000C000001
10XEX000100000000X001
10000X000000000100001
100P00000010000000001
1X0000C0000X000C00001
111111111111111111111